Lista de la mañana: Día 1<br>¡Tienes una carta de amor!	Día 1
Lista de la mañana: Día 2<br>¡Tienes una carta de amor!	Día 2
Lista de la mañana: Día 3<br>¡Tienes una carta de amor!	Día 3
Lista de la mañana: Día 4<br>¡Tienes una carta de amor!	Día 4
Lista de la mañana: Día 5<br>¡Tienes una carta de amor!	Día 5
Lista de la mañana: Día 6<br>¡Tienes una carta de amor!	Día 6
Lista de la mañana: Día 7<br>¡Tienes una carta de amor!	Día 7
Lista de la mañana: Día 8<br>¡Tienes una carta de amor!	Día 8
Lista de la mañana: Día 9<br>¡Tienes una carta de amor!	Día 9
Lista de la mañana: Día 10<br>¡Tienes una carta de amor!	Día 10
Lista de la mañana: Día 11<br>¡Tienes una carta de amor!	Día 11
Lista de la mañana: Día 12<br>¡Tienes una carta de amor!	Día 12
Lista de la mañana: Día 13<br>¡Tienes una carta de amor!	Día 13
Lista de la mañana: Día 14<br>¡Tienes una carta de amor!	Día 14
Lista de la mañana: Día 15<br>¡Tienes una carta de amor!	Día 15
Lista de la mañana: Día 16<br>¡Tienes una carta de amor!	Día 16
Lista de la mañana: Día 17<br>¡Tienes una carta de amor!	Día 17
Lista de la mañana: Día 18<br>¡Tienes una carta de amor!	Día 18
Lista de la mañana: Día 19<br>¡Tienes una carta de amor!	Día 19
Lista de la mañana: Día 20<br>¡Tienes una carta de amor!	Día 20
Lista de la mañana: Día 21<br>¡Tienes una carta de amor!	Día 21
Lista de la mañana: Día 22<br>¡Tienes una carta de amor!	Día 22
Lista de la mañana: Día 23<br>¡Tienes una carta de amor!	Día 23
Lista de la mañana: Día 24<br>¡Tienes una carta de amor!	Día 24
Lista de la mañana: Día 25<br>¡Tienes una carta de amor!	Día 25
Lista de la mañana: Día 26<br>¡Tienes una carta de amor!	Día 26
Lista de la mañana: Día 27<br>¡Tienes una carta de amor!	Día 27
Lista de la mañana: Último día<br>¡Tienes una carta de amor!	Día 28