Compiti per le vacanze: Giorno 1! <br> Hai ricevuto 1 rete leggendaria!	Giorno 1
Compiti per le vacanze: Giorno 2! <br> Hai ricevuto 1 rete leggendaria!	Giorno 2
Compiti per le vacanze: Giorno 3! <br> Hai ricevuto 1 rete leggendaria!	Giorno 3
Compiti per le vacanze: Giorno 4! <br> Hai ricevuto 1 rete leggendaria!	Giorno 4
Compiti per le vacanze: Giorno 5! <br> Hai ricevuto 1 Miaobiglietto!	Giorno 5
Compiti per le vacanze: Giorno 6! <br> Hai ricevuto 1 rete leggendaria!	Giorno 6
Compiti per le vacanze: Giorno 7! <br> Hai ricevuto 1 rete leggendaria!	Giorno 7
Compiti per le vacanze: Giorno 8! <br> Hai ricevuto 1 rete leggendaria!	Giorno 8
Compiti per le vacanze: Giorno 9! <br> Hai ricevuto 1 rete leggendaria!	Giorno 9
Compiti per le vacanze: Giorno 10! <br> Hai ricevuto 1 Miaobiglietto!	Giorno 10
Compiti per le vacanze: Giorno 11! <br> Hai ricevuto 1 rete leggendaria!	Giorno 11
Compiti per le vacanze: Giorno 12! <br> Hai ricevuto 1 rete leggendaria!	Giorno 12
Compiti per le vacanze: Giorno 13! <br> Hai ricevuto 1 rete leggendaria!	Giorno 13
Compiti per le vacanze: Giorno 14! <br> Hai ricevuto 1 rete leggendaria!	Giorno 14
Compiti per le vacanze: Giorno 15! <br> Hai ricevuto 1 Miaobiglietto!	Giorno 15
Compiti per le vacanze: Giorno 16! <br> Hai ricevuto 1 rete leggendaria!	Giorno 16
Compiti per le vacanze: Giorno 17! <br> Hai ricevuto 1 rete leggendaria!	Giorno 17
Compiti per le vacanze: Giorno 18! <br> Hai ricevuto 1 rete leggendaria!	Giorno 18
Compiti per le vacanze: Giorno 19! <br> Hai ricevuto 1 rete leggendaria!	Giorno 19
Compiti per le vacanze: Giorno 20! <br> Hai ricevuto 1 Miaobiglietto!	Giorno 20
Compiti per le vacanze: Giorno 21! <br> Hai ricevuto 1 rete leggendaria!	Giorno 21
Compiti per le vacanze: Giorno 22! <br> Hai ricevuto 1 rete leggendaria!	Giorno 22
Compiti per le vacanze: Giorno 23! <br> Hai ricevuto 1 rete leggendaria!	Giorno 23
Compiti per le vacanze: Giorno 24! <br> Hai ricevuto 1 rete leggendaria!	Giorno 24
Compiti per le vacanze: Giorno 25! <br> Hai ricevuto 1 Miaobiglietto!	Giorno 25
Compiti per le vacanze: Giorno 26! <br> Hai ricevuto 1 rete leggendaria!	Giorno 26
Compiti per le vacanze: Giorno 27! <br> Hai ricevuto 1 rete leggendaria!	Giorno 27
Compiti per le vacanze: Giorno 28! <br> Hai ricevuto 1 rete leggendaria!	Giorno 28
Compiti per le vacanze: Giorno 29! <br> Hai ricevuto 1 rete leggendaria!	Giorno 29
Compiti per le vacanze: Giorno 30! <br> Hai ricevuto 1 Biglietto raro!	Giorno 30